WE ./maps_texture/west.xpm 
SO ./maps_texture/south.xpm
NO ./maps_texture/north.xpm
EA ./maps_texture/east.xpm

F 0,191,,,,,,,,,,,,,,,,,,,,,,255
C 25,,,,,,,,,,,,, 5, 19 2

111111111111111111
100000000000000001
100000010000000001
100010000000000001
100000001000001001
100010001W10001001
100000000000100001
111111111111111111